sleek cotton soap	Aut ut cumque adipisci mollitia suscipit voluptatem. Quam sunt omnis cumque ipsa. Corrupti voluptas quia id maxime. Totam est temporibus ut est quia aut et consequatur. Impedit enim nihil optio magnam ipsa voluptatum ut enim esse. Voluptatibus hic vel incidunt voluptatibus nam.	NOW()	NOW()
incredible steel towels	Expedita minus iure in molestiae et. Ut nostrum ea cum et. Ad ratione mollitia beatae sed et veniam ad voluptas aut. Voluptates quasi non aut quis eos ut velit tempora.	NOW()	NOW()
small steel shoes	Aut ullam et quod adipisci voluptatem aut aut excepturi temporibus. Ea harum molestiae enim corrupti et. Enim et natus autem. Quaerat natus nisi earum voluptas qui. Blanditiis accusantium iste enim a.	NOW()	NOW()
intelligent granite pants	Repudiandae blanditiis ipsum veniam eum dolores. Tempora neque deleniti nihil qui autem sint qui officia. Cum suscipit eaque. Officiis accusantium sit voluptas. Unde repudiandae aperiam hic natus. Qui animi quo libero tenetur tempore eum molestiae itaque accusantium.	NOW()	NOW()
incredible metal ball	Dolor ea deleniti accusantium amet delectus ipsam dignissimos et. Et pariatur ut consequatur consequatur. Molestiae facilis temporibus quis magni cumque iure. Alias sint explicabo unde ut minima. Hic animi nam non provident quis et.	NOW()	NOW()
gorgeous rubber keyboard	Magni est assumenda et enim nostrum itaque ratione. In deserunt consequuntur. Dolore odit et ad ex laboriosam.	NOW()	NOW()
licensed metal mouse	Ratione debitis qui asperiores nostrum accusantium earum ducimus ullam sequi. Vero numquam itaque dolores exercitationem id nam. Optio ab error sed voluptas. Et porro odit. Quae qui rerum omnis cum quam quidem.	NOW()	NOW()
unbranded fresh hat	Dolorum minus quo at consequuntur quis sed ipsam. Quia harum rem perferendis rerum dolorum non esse. Praesentium enim eum voluptas eligendi vel error modi totam.	NOW()	NOW()
small rubber chicken	Consequatur voluptas fugiat tempore sed. Voluptatem aspernatur non temporibus. Est suscipit voluptatem autem nulla veniam laborum. Aut consequatur fugiat consectetur pariatur cumque ipsam corporis voluptatem at. Quia facere inventore alias. Accusantium et rerum maxime accusantium sapiente officia in.	NOW()	NOW()
ergonomic concrete table	Sapiente dolores nesciunt fugit doloremque. Voluptatem molestias rerum animi qui maxime deleniti illum laborum. Ipsa officiis neque quas in quibusdam.	NOW()	NOW()
licensed metal bacon	Aliquid pariatur ab. Est sapiente accusantium saepe animi ducimus. Quisquam quia in exercitationem consectetur et aliquid eos qui.	NOW()	NOW()
handmade cotton computer	Velit deserunt illum consequatur. Eaque laborum itaque a fugit consequatur voluptatem. Quam voluptatem quo dolores fuga.	NOW()	NOW()
small wooden tuna	Id facilis quidem facilis quis ratione corrupti. Qui dolorem accusantium dicta enim vel autem molestias. Vitae ea ad ut unde ea. Repellat provident maiores consectetur facere qui. Quia et modi natus quod distinctio. Quasi recusandae officia et magni atque reprehenderit ipsum perspiciatis.	NOW()	NOW()
handmade metal hat	Autem sequi aspernatur. Vero sequi qui reiciendis nesciunt quia facere. Ducimus non est sed error qui eum repudiandae. Tempore et molestiae veritatis modi voluptas sed ut ratione inventore.	NOW()	NOW()
gorgeous steel chair	Aut voluptas et eius optio. Rerum unde ad mollitia. Nihil qui qui quam dolor quo perferendis.	NOW()	NOW()
tasty plastic chicken	Soluta qui veritatis aut assumenda alias libero et. Possimus eos est rerum cum. Voluptatem dolores eligendi consequatur laborum vero doloremque.	NOW()	NOW()
licensed wooden sausages	Dicta quis eum doloribus natus iure. Sunt aperiam aliquam incidunt expedita natus tenetur officiis voluptate. Occaecati omnis vitae quisquam id cupiditate nesciunt soluta repudiandae. Totam aperiam non possimus harum repudiandae explicabo aliquam ratione.	NOW()	NOW()
sleek steel salad	Dignissimos sit consectetur architecto alias et deserunt. Iste rerum odio sed iste veniam quibusdam. Iste autem est rerum ut est natus et. Nihil sed deleniti aut cum error et minima.	NOW()	NOW()
gorgeous fresh computer	At tenetur eos et esse eos fuga laboriosam tempore saepe. Consectetur sunt aspernatur quae quibusdam enim ipsam. Aut recusandae et enim voluptas. Et quibusdam ipsum.	NOW()	NOW()
unbranded granite fish	Officia non quo quae quisquam est cumque reiciendis. Quas ab et. Qui commodi totam delectus commodi sunt fugit quos aspernatur est. Quod dolores ex temporibus. Ratione at eum.	NOW()	NOW()
handmade plastic bacon	Qui enim quisquam doloribus iste ullam et aut. Sunt repellendus tenetur est autem quidem et et et. In quod nostrum eligendi in totam sed harum voluptatum. Nulla aut enim omnis nemo id sint. Amet doloremque aliquid labore dolor incidunt vitae recusandae eligendi quo.	NOW()	NOW()
incredible plastic sausages	Itaque dicta consequatur aut culpa vero repudiandae iste. Ratione fugit incidunt illum id id labore. Quis assumenda dolorem earum aut nemo ipsam nemo eum. Consequatur magni reprehenderit reprehenderit labore adipisci dolor. Minima est quis voluptates omnis. Nihil aut adipisci quo enim tempore et velit.	NOW()	NOW()
awesome steel fish	Rerum quia reprehenderit reiciendis quia fugiat corrupti id sed. Illo in et incidunt debitis eos soluta molestias. Consectetur quo sit reiciendis ullam et occaecati. Suscipit possimus placeat qui asperiores qui ad ut est iure. Quia magnam dolor consectetur itaque. Soluta voluptatem ad.	NOW()	NOW()
intelligent granite ball	Quos culpa in architecto sit totam ipsa illum veritatis neque. Omnis molestias sit iure aut amet rerum aut tempora. Sit odio sit voluptatem sint perferendis et.	NOW()	NOW()
gorgeous soft pizza	Et itaque fugiat esse aspernatur est ab excepturi ut officiis. Qui ab et enim ex accusamus adipisci dicta quia sapiente. Assumenda sint qui facere ipsam dolore enim hic.	NOW()	NOW()
handcrafted frozen computer	Quia beatae nihil sit quam sit qui. Dolor voluptatum occaecati repudiandae odio deleniti harum perferendis dolorem quaerat. Nemo odit ad molestias excepturi et.	NOW()	NOW()
generic concrete gloves	Quo totam est et est numquam. Eos reiciendis in magnam quis laborum. Odio eaque et commodi sit. Vel fuga ipsam quisquam. Fugit aliquid eos sit ratione modi necessitatibus et. Quidem reiciendis laudantium perspiciatis et.	NOW()	NOW()
small wooden towels	Possimus modi qui sed omnis corrupti. Porro deserunt maiores cumque. Libero voluptatem repellendus perspiciatis. Ullam itaque sint fugit. Iste qui consequatur temporibus autem voluptatem dolore et id.	NOW()	NOW()
sleek soft mouse	Et quo sequi voluptatibus et cum repellat cupiditate eius maxime. Voluptatem nihil culpa assumenda blanditiis dolor voluptatibus cum illum enim. Iste est ut vel similique qui vero corporis qui. Quae earum fugiat. Officia autem illum in. Nisi culpa earum temporibus odit accusantium dolor voluptatum.	NOW()	NOW()
awesome soft chair	Iste sed sed sed quis. Distinctio non expedita qui et cum ut quibusdam rerum at. Hic doloribus quasi ut soluta quaerat quidem nihil suscipit.	NOW()	NOW()
refined wooden pizza	Et excepturi incidunt eaque officia dolorem fugit nesciunt. Dignissimos hic exercitationem iusto soluta nam dolor sapiente quidem et. Placeat ut corrupti eum voluptatem ipsa velit quas.	NOW()	NOW()
handcrafted concrete hat	Sunt iusto quod quae repellendus voluptatem consequuntur. Itaque sapiente nisi voluptatum provident corporis est fugiat sit impedit. Temporibus dolores nihil quasi quasi ducimus. Tempore saepe ad ut laborum qui reprehenderit commodi est. Minus soluta magnam unde veniam facere velit fugit. Laborum voluptates rerum sapiente similique molestiae rerum fugit.	NOW()	NOW()
gorgeous frozen pizza	Facere enim aut repellat dolore accusamus dolores hic. Enim rerum quasi rem perferendis excepturi similique reprehenderit ipsa voluptates. Ut voluptatum tempora et magni sunt sed illum. Est sed voluptatem error perferendis et.	NOW()	NOW()
gorgeous metal chicken	Maiores est recusandae. Molestiae repellat molestiae. Ipsam dolor hic at.	NOW()	NOW()
handcrafted wooden tuna	Id et numquam excepturi voluptas praesentium voluptatum voluptatum quod. Consequatur nemo illo quos quia numquam. Rerum dignissimos eveniet distinctio ut similique. Quae nisi molestiae sapiente sit est.	NOW()	NOW()
refined rubber soap	Ab rem voluptas deserunt est dolor cum voluptatem quia. Porro reiciendis aliquam sed excepturi est exercitationem saepe sequi. Qui quo quod. Fugiat sit similique molestiae id quis. Cumque omnis ipsam dolore iusto vel aut et nihil.	NOW()	NOW()
intelligent plastic pants	Quo ipsam dolores quidem est inventore harum occaecati reprehenderit minima. Illum autem autem perferendis. Dolorem quis mollitia voluptatem ut sint rem consectetur architecto illo. Laborum voluptates enim pariatur necessitatibus voluptatem libero laborum. Et eius dolorem repudiandae et ea natus perspiciatis facere. Nisi itaque voluptatem totam fuga omnis facere quo tempore.	NOW()	NOW()
handcrafted metal bacon	Recusandae qui ratione iusto. Officia voluptas eos est. Mollitia quia voluptate.	NOW()	NOW()
licensed steel bacon	Enim nam qui. Omnis inventore ratione quasi quae. Omnis harum repudiandae temporibus et consequatur et.	NOW()	NOW()
tasty soft tuna	Distinctio quisquam quae sunt dolor est laboriosam id nesciunt non. Expedita deserunt rerum corrupti occaecati. Aut nobis et quia iste sit culpa exercitationem vel. Et vitae necessitatibus accusantium atque rerum ex.	NOW()	NOW()
unbranded metal ball	Voluptatem et qui sequi doloremque nostrum iure quisquam et at. Est dolores minima incidunt et error placeat doloribus quam. Ab ut vel. Aperiam commodi illo atque.	NOW()	NOW()
gorgeous rubber shoes	Ut qui magnam temporibus minus illo vel voluptatibus occaecati officia. Quia temporibus iusto eos iste autem architecto iste voluptatibus. Vel excepturi molestiae distinctio repudiandae tempora iusto et. Magni placeat voluptates ut expedita sit. Blanditiis ratione minus facilis.	NOW()	NOW()
ergonomic cotton tuna	Autem officiis est sed non veritatis incidunt aspernatur. Et quod qui quia consequuntur nostrum porro architecto aut. Quis enim sed fugiat non. Error illo et rerum aut quisquam dignissimos quis. Placeat consequatur ab qui.	NOW()	NOW()
awesome steel keyboard	Est ab voluptatem libero omnis consequatur porro et. Officiis nisi laborum dignissimos quidem est. Nihil est a id quo. Quas ut in rem consequuntur eos voluptatem quaerat itaque. Molestiae ut aut consequatur ut est ea.	NOW()	NOW()
generic wooden cheese	Temporibus dicta dolorum. Delectus alias recusandae voluptatem. Id voluptas laboriosam. Aut neque quia quibusdam. Repellendus nostrum eos.	NOW()	NOW()
gorgeous wooden chair	Similique mollitia id. Veritatis et adipisci temporibus ab reprehenderit veritatis sit voluptatibus. Et sint quo autem enim quo beatae modi libero. Officia facilis inventore optio recusandae temporibus.	NOW()	NOW()
unbranded fresh chair	Sint eius quisquam id vel in facilis quos. Deleniti id quas voluptates cumque laboriosam error alias autem. Facere quidem aliquam consequatur architecto.	NOW()	NOW()
handmade metal table	Quaerat quos voluptas quaerat ut. Id laudantium in quod asperiores aut. Dolorem nostrum et pariatur facere esse officia dolore voluptates aliquid.	NOW()	NOW()
rustic soft mouse	Provident asperiores dolorem. Culpa qui maiores voluptas ut repellendus consequatur veniam et voluptas. Exercitationem quis non provident modi et ut enim iusto. Iure mollitia nisi accusamus est dolore perferendis. Dolores id aut exercitationem qui. Et est in dignissimos vel deserunt sed est nihil.	NOW()	NOW()
unbranded wooden pants	Magni architecto mollitia. Et voluptas ex est quasi corrupti voluptate aut sint. Est illum reiciendis veritatis deleniti ut. Repudiandae culpa aut.	NOW()	NOW()
small frozen fish	Nostrum repellendus molestiae mollitia. Alias blanditiis rerum ullam corporis pariatur est qui hic ducimus. Ut ab vel placeat doloribus et asperiores.	NOW()	NOW()
awesome plastic gloves	Sed officia provident incidunt. Esse labore sapiente totam. Sequi consequatur totam dolorem praesentium placeat dolorum. Nesciunt voluptas ipsum deleniti ducimus ipsum quis. Omnis omnis consequuntur praesentium excepturi ad. Minus cupiditate sed odit neque velit impedit architecto.	NOW()	NOW()
licensed plastic chips	Qui a est nisi qui nostrum non magnam. Unde mollitia totam non fugiat assumenda eum in. Et natus amet quibusdam non. Minus libero aliquam eaque saepe. Eius eum quo ut corporis et accusantium quis.	NOW()	NOW()
handmade soft car	Illum veniam quo omnis vero harum amet quia. Dicta delectus porro repellendus aut inventore. Assumenda voluptatibus autem vel ipsam fuga qui eum repellendus sequi. Sit aperiam in culpa perspiciatis fuga. Ut est illo est voluptas in molestias ea. Perferendis architecto nobis ut consequatur voluptatem id at earum.	NOW()	NOW()
generic soft towels	Reprehenderit quidem asperiores sunt vitae molestiae voluptas. Voluptatum veritatis non laboriosam autem molestiae quos eaque provident fugit. Corrupti odio accusamus laudantium ullam perspiciatis qui cupiditate autem quibusdam.	NOW()	NOW()
awesome soft gloves	Qui et eum deserunt odio est autem. Fuga voluptates eum facilis. Similique consequuntur voluptas incidunt. Quis iste eaque sed aut non.	NOW()	NOW()
handmade cotton shirt	Sequi ut saepe cupiditate nulla impedit. Occaecati minus est velit fuga. Odit officia sed.	NOW()	NOW()
unbranded frozen table	Sed dignissimos dolorem sed quo ipsa. Provident quae voluptatibus et qui quasi aut libero cum. Aut qui earum quaerat rerum possimus. Cupiditate harum ut molestias. Iste est officiis aut totam.	NOW()	NOW()
rustic granite soap	Nostrum voluptatem tempora. Recusandae incidunt iste laudantium sit ab. Aut porro placeat in minima aut quis. Accusantium aut culpa nesciunt vel dolores modi odit. Et quia et eius enim dolorem voluptatibus laboriosam esse quos. Vel iusto voluptatem excepturi neque dolorum animi eum.	NOW()	NOW()
handcrafted frozen salad	Sequi quis eveniet adipisci sequi rerum voluptas non. Sed dolores qui eligendi sed minima quis. Ut ea illo. At omnis vel repudiandae dignissimos soluta sint alias rerum quod. Soluta quis voluptatibus qui omnis est quia. Tempora ipsum omnis officia.	NOW()	NOW()
practical soft keyboard	Mollitia alias incidunt et nostrum quas consequatur consequuntur qui omnis. Hic quas minus accusamus vitae. Et dolores numquam velit veniam nam. Nihil asperiores consequuntur animi. Eius est distinctio temporibus quos voluptates odit. Ad et perspiciatis natus a vitae placeat aut ut.	NOW()	NOW()
gorgeous cotton bacon	Veniam ad dolorum velit aut aliquid ea illum enim autem. Consequatur impedit ipsum reprehenderit itaque odio. Fugit dolor rerum porro aut molestias repudiandae hic. Dolor culpa et ut necessitatibus fuga.	NOW()	NOW()
sleek plastic tuna	Delectus ullam iure natus qui natus dolor aut pariatur. Ipsum neque laborum facere. Tempora perspiciatis at facere rerum maiores.	NOW()	NOW()
refined cotton chicken	Distinctio fugiat autem voluptas aspernatur omnis odit ea assumenda. Et veritatis sed eius natus autem illum vel sequi quia. Libero animi voluptatem fugit nihil qui fuga non et. Asperiores delectus perferendis reprehenderit itaque maxime quia. Eius illo ut.	NOW()	NOW()
handcrafted fresh chair	Nesciunt ea illo ut. Autem dolorem occaecati nihil et similique non qui sapiente. Repellat aut eveniet eaque cumque aut delectus cupiditate nesciunt. Labore doloribus facere assumenda non. Perferendis aperiam illum.	NOW()	NOW()
gorgeous fresh computer	Quae repellat ut sequi. Rerum aut placeat et nisi dolores voluptates nemo earum doloremque. Quis iste sapiente. Quo qui rerum qui quos inventore ut delectus maxime. Totam unde numquam dolores mollitia.	NOW()	NOW()
tasty plastic bike	Voluptas perferendis vel velit a iste. Impedit vitae laudantium doloribus reprehenderit dolores distinctio vel hic. Impedit exercitationem sint soluta necessitatibus animi. Et excepturi nihil veniam aut.	NOW()	NOW()
fantastic frozen salad	Optio modi eos ducimus esse. Nulla non sunt perferendis similique maiores commodi tempore. Ex et nemo dolores deserunt porro delectus. Excepturi voluptatem ipsum pariatur totam veritatis aut rerum. Qui aut iure vel.	NOW()	NOW()
tasty soft chair	Id itaque quia voluptas illum aliquid aut eum autem. Et nam totam in eos consequatur aperiam laboriosam corporis. Et dignissimos natus perferendis saepe quibusdam veniam dolores. Rerum dolor earum error et modi est enim impedit omnis. Eos quidem voluptas velit fuga ea eveniet nemo qui.	NOW()	NOW()
awesome metal cheese	Quis a neque earum at nesciunt. A dolorum eaque inventore aut praesentium nihil consequatur aliquam. Et officiis dicta nulla quod id excepturi error numquam. Quas at sed officia omnis adipisci mollitia. Accusamus asperiores libero.	NOW()	NOW()
ergonomic cotton salad	Omnis ea omnis vitae qui quas quod inventore voluptatem. Est libero vel quasi dolor tempora numquam. Magnam qui qui vel unde.	NOW()	NOW()
intelligent soft keyboard	Autem minima quo sunt magnam dolores aut odio hic. Aperiam cumque occaecati ipsa labore laudantium voluptas rerum ab sit. Et sint ad. Error at sapiente.	NOW()	NOW()
fantastic steel soap	Saepe asperiores vel officia. Dicta recusandae ducimus eos quisquam illo aut quia quo. Voluptatum qui voluptates. Eos quidem qui facere. Et deserunt maxime atque distinctio maxime molestias quia modi. Totam voluptatem itaque.	NOW()	NOW()
fantastic wooden chips	Et sint natus voluptatem et voluptas qui maiores qui. Deleniti et minus. Doloremque amet ex repudiandae eos ipsa harum.	NOW()	NOW()
generic steel cheese	Natus temporibus et iste veniam recusandae ut. Tenetur rerum nam magni ut suscipit totam omnis omnis. Autem blanditiis repudiandae.	NOW()	NOW()
tasty rubber fish	Blanditiis id sit impedit harum dolores. Vel quibusdam est voluptatem voluptate labore hic minima. Excepturi velit perspiciatis. Assumenda qui natus vel fugit nihil. Temporibus aut vero ea omnis consequatur.	NOW()	NOW()
gorgeous frozen chicken	Sit aut veniam beatae ad quos. Numquam velit quia rerum perspiciatis nulla nihil. Modi explicabo natus quis quibusdam. Sit rerum necessitatibus voluptatem suscipit et aut. Fugiat aut maxime numquam facilis voluptatem velit aliquid.	NOW()	NOW()
ergonomic metal pants	Velit dolorem praesentium commodi consequatur ad modi et consequatur. Sunt quisquam dolorum reprehenderit esse. Sequi dolorem quis sit quo quos sint error et. Molestiae aut voluptatibus commodi dicta. Reprehenderit aliquam qui maiores alias libero non vel. Et odit molestiae eos fugiat.	NOW()	NOW()
small fresh fish	Vitae accusantium non sit nam corporis voluptas iure suscipit velit. Velit officiis ut ducimus quae ipsa sed saepe. Laudantium veritatis ex nesciunt delectus. Eos sunt laudantium in ipsam ut ullam ea asperiores. Suscipit sunt sequi ipsa aspernatur omnis.	NOW()	NOW()
generic soft fish	Optio dolorem error. Et non ut. Molestiae repellendus dolores quo exercitationem sunt ratione.	NOW()	NOW()
refined frozen shoes	Aut fugiat dolor ut libero non et tempore nulla ipsum. Recusandae distinctio error neque quo est repellendus animi. Esse suscipit rem ex vero enim aperiam nulla. Sit fugit facere excepturi culpa quis itaque corrupti. Qui quod aliquam eaque nesciunt ab et modi. Repellendus dolorum quae tempore qui voluptas facilis accusamus.	NOW()	NOW()
incredible cotton gloves	Vel quo fugit voluptatem dicta sit ipsam nihil suscipit. Error veritatis sapiente quidem aut. Velit quas in animi eligendi aut.	NOW()	NOW()
small rubber chips	Et numquam ut nisi possimus dolores consequuntur aut. Qui in voluptatem et modi dolorem. Dolorem inventore atque est inventore reprehenderit unde id quisquam. Et illo quisquam voluptas.	NOW()	NOW()
incredible frozen car	Ducimus itaque officiis at tempora enim. Maxime sed dolore incidunt nihil est. Quod laboriosam numquam officiis eum quam. Nihil nisi id nihil at quidem accusantium non nulla. Distinctio et similique et est ab adipisci ratione et sit. Dolores fugit sapiente.	NOW()	NOW()
gorgeous steel shirt	Consequatur omnis rerum voluptas facilis ea quis ad consequatur. Expedita voluptatem illum excepturi. Dolorem repellat vero unde maxime aut earum optio architecto. Placeat eveniet odio ut.	NOW()	NOW()
gorgeous wooden tuna	Est a necessitatibus nisi inventore quod. Incidunt tempora adipisci consequuntur eius impedit repellat molestiae aut. Voluptatem similique sapiente corrupti at. Dolorum quia doloremque nulla.	NOW()	NOW()
handmade frozen salad	Reiciendis commodi laborum enim minus ducimus. Et voluptate dolorem non molestiae pariatur sint omnis itaque. Iure voluptates rerum suscipit et mollitia dolorem inventore harum. Recusandae deleniti ullam odit aut. Aperiam aliquid minima.	NOW()	NOW()
small rubber salad	Dolores animi odio quae id. Maiores possimus reprehenderit deleniti voluptate placeat et omnis. Nisi sunt harum culpa quia et voluptatibus.	NOW()	NOW()
generic wooden ball	Quidem vero alias. Vitae sit molestias molestias. Id quia sit aliquam impedit mollitia nostrum aut eos. Magni qui magni ea incidunt aspernatur.	NOW()	NOW()
intelligent metal table	Aut accusamus provident impedit. Ab aperiam in animi facere incidunt. Quo ut ullam in sapiente nostrum ipsam rem tempore sit. Sint ad temporibus dolorum architecto ut. Sit optio corporis eaque quia dolor ea quo. Dolor voluptatibus veniam molestiae.	NOW()	NOW()
sleek concrete tuna	Ea quibusdam quidem placeat quae voluptate qui aliquid. Architecto occaecati voluptas assumenda eius repudiandae itaque iure est. Natus eius dolores beatae. Nihil at voluptate et repellendus officia tenetur qui atque. Esse qui necessitatibus rerum quia odit. In saepe eos delectus voluptates dicta autem animi nihil.	NOW()	NOW()
tasty metal pants	A adipisci explicabo et aperiam unde quod accusantium. Non qui praesentium minima impedit et repellat. Quo aut omnis. Et accusamus id voluptatem asperiores voluptate est ab tenetur consequatur. Explicabo aperiam qui aut fuga tenetur ab quod iste. Magnam repellat laborum.	NOW()	NOW()
licensed cotton gloves	Labore in voluptas. Eveniet quisquam sit repudiandae assumenda vel animi. Error voluptatibus non.	NOW()	NOW()
licensed cotton fish	Enim quam atque minus. Quaerat et quos doloremque sequi omnis dolore. Similique consequatur eveniet eaque distinctio ut minima quam sunt. Sed ut assumenda quia culpa quia.	NOW()	NOW()
gorgeous fresh towels	Mollitia exercitationem accusamus ea et rerum quaerat ab. Labore possimus eos nobis et atque. Quasi consequatur et suscipit ratione ab. Accusantium sit ea quam qui ipsam nemo voluptatum.	NOW()	NOW()
small steel car	Atque sint sed et. Voluptatem architecto et. Qui reprehenderit qui consequatur iusto. Laboriosam expedita at qui pariatur ut vel ut. Rerum sit non corrupti doloribus enim numquam nihil et laborum.	NOW()	NOW()
practical concrete pizza	Eligendi est nisi. Voluptas expedita vitae. Repudiandae non commodi.	NOW()	NOW()
handcrafted rubber gloves	Eaque consectetur quidem tempore. Rem non et doloremque eum praesentium exercitationem. Atque at nemo dolorem et enim mollitia.	NOW()	NOW()
licensed wooden shoes	Voluptatem est consectetur. Et repellat quos consequuntur possimus ut enim. Quia assumenda molestiae qui placeat qui soluta. Maiores aut est quibusdam animi esse. Et quisquam dolorem molestiae. Reprehenderit sunt quae est dolor omnis ducimus.	NOW()	NOW()
practical cotton mouse	Labore non assumenda delectus tempore et nam aspernatur vel veniam. Ut delectus et nam molestiae voluptatem. Consequatur quisquam mollitia iste incidunt ut ducimus.	NOW()	NOW()
